#####---
#.@.###-
#000#.#-
#...#.#-
##.##.##
-#.222$#
-#######
