-#####---
-#.#.#---
-###$#---
##@######
#...#...#
#202#202#
#...#...#
#########
