-#######--
-#...0.###
-#.0...#.#
####.###.#
#3##03#3.#
#.###.#.##
#.##3.#.#-
####@##.#-
#$#####3#-
###---###-
