-------###
########.#
#$#......#
###.####.#
#@..#..###
#1102....#
##0#0#####
-#.#2.#---
-######---
