###-###-##-
#---#-#-#-#
###-#@#-#-#
#---#-#-#-#
###-#-#-##-
-----------
-----------
-----------
