###-###-##-
#---#-#-#-#
###-#-#-#-#
#---#-#-#-#
###-#-#-##-
-----------
-----------
-----------
