--#####--
###...#--
#...#.#--
#22.#@#--
#.#.###--
#####.###
#.2.#...#
###$#.2.#
--###..##
----####-
