#########
#@..#...#
#.2...#.#
#...###.#
#.###.#.#
#.#.#..##
#.#2##..#
#.#...#.#
#.###..##
#....#..#
#######$#
------###
