##########
#...#..2.#
#.#3#.##.#
#$#..2.1.#
###@######
--###-----
