#####--
#.$.#--
#######
#2.2#.#
#.@.#.#
#3.2#.#
#######
