###---------
#$#---------
###--######-
######.S..##
#.#.##.3#..#
#......2.#@#
#.#.##.1#..#
######.0..##
###--######-
#$#--------
###--------
