#####
#.2.#
#.1.#
#.@.#
#.#.#
#.S.#
#####
-#$#-
-###-
