-#######
-#..S.S#
-#.#1#.#
-#.S.#@#
##...###
#2...2#-
#######-
--#$#---
--###---
