-----###
######$#
#..22###
#@..##1#
##SS.#2#
-#0#...#
-#######
